  xx   xxx    x   x     x  x xx xx x x x
           x x              x           
     xxx      x x     x   x x   xx      
x  x   xxxx  x  xx x  x            x    
 x    x   x  x   x       x              
  x   x x    x    x   xx  x         x x 
   x            x  xx   x               
x x x        x      x x  xx  x   x   x x
x x   x    x        x       x         x 
 x         x xx   x xx          x       
             x          xx   x         x
  xx x  x x                     x       
xx     x     xx  x   x   x   x    x     
     x   x      xx  x        x     xx   
x         x  x     xx     x         x   
 x          x             x       x    x
 x x      x  xx    x       x    x   x  x
           x               x          x 
  x   x    x    x x     xxx             
  x xx    x  xx      x      x  x    x xx
      x    x  x   x  xxx x x x x x     x
              x   x         xx   xx  x  
     x  x     x x            x  xx x    
     x    x         x               x   
 xx  x                    xxx    x      
   x  x  x x          x  x x   x        
x        x             xx  x  x     xx x
   x            xx     x x   x     x    
                     x  x       xx      
x           xx      x      xx         x 
  xx       x       x                 x x
                    x     x    xx xx xx 
 x    x x        xx  x      x    xx     
  x           xxx  x       x            
 x x   x xxx       x     x      x    xx 
    x  x    x   xx    x      x   x      
     x  x               x          x x  
  x  x                     x   xxx      
 x            x x x xx  x xx   x        
x             x           x    xx x   xx
